10 10
5 7
- - - - - - - - - -
- + - - - - - M - -
- + - - - - - - - -
- + M - - - - - - -
- + - - - - - - - -
- + M - - - - - - -
- - - - - + - - - -
+ - - - - @ - - - -
+ ! - - - - - - - -
- - M - - - - - - -