7 5
5 1
- - - - -
- - + - -
- $ + M -
- + + - -
- - - - -
- - - - M
- - - ! -
